1111111111111111111111111111111111
1E0000000000000C00000C000000000001
1010010100100000111001000000010101
1010010010101010001001001000011101
1P0000000C00C0000000000011100000C1
1000011100000000000010000010000001
1111111111111111111111111111111111