1111111111111111111111111111111111
100000000000000C00000C00000000PCE1
1010010100100000111001000000010101
1010010010101010001001001000011101
1000C0000C00C0000000000011100000C1
1000011100000000000010000010000001
1111111111111111111111111111111111