1111111111111111111111111111111111
100000000000000C00000C000000000CE1
10100101001000001110010000CC010101
101001001010101000100100100P011101
1000C0000C00C0000000000011100000C1
1000011100000000000010000010000001
1111111111111111111111111111111111