1111111111111111111111111111111111
100000000000000C00001C100000000CE1
10100101001000001110001000CC010101
10100100101010100010010010P0011101
1000C0000C00C0000000000011100000C1
1000011100000000000010000010000001
1111111111111111111111111111111111