111111111111111111111
10C10000000C1000000E1
100001111100110110011
10000100010011C100001
1P0011C000000001001C1
111111111111111111111